1111111111111111111
1E01C00001C000010P1
1001001001001001001
1001001001001001001
1001001001001001001
1C00001C00001C00001
1111111111111111111
1111111111111111111
1000000000000000001
1010101010001011101
1010101010001010001
1011101001010011101
1010101001010010001
1010101000100011101
1000000000000000001
1111111111111111111