111111111111111111111111111
110P0001111000C000000110E11
110000011110000111000110011
110000011110000111000110011
110000011110000111000110011
110000011110000111000110011
1100C0011110000111000110011
110000011110000111000110011
110000011110000111000110011
110C00000000000111000000011
111111111111111111111111111