1111111111111111111
1E000110C01000C0001
1000011000C00C00001
100C01110C01110C001
1C00000000C0110C001
100C00001000110C0P1
1111111111111111111