111111111111111111111111111111
1E000000000C00000C000000000001
101001010010001001000000010101
101001001010101001000000010101
1P0000000C00C000000000000000C1
111111111111111111111111111111