111111111111111111111111111111111111111111111111111111111111111111111111111111111
1E0000000000000000000000000000000000000000C000000000000000000000000000000000000P1
111111111111111111111111111111111111111111111111111111111111111111111111111111111